1111111111111
111100C000IC1
1C10011111001
1P1011E000001
1111111111111
