1111111111111111111
10000000C0000001111
1001011111000001111
10010000C1000P01111
1001000111000E01111
10001111101100000C1
1111111111111111111
